1 b 1 1
1 1 1 1
1 1 e 1
1 1 1 1
1 x x 1
1 1 1 1