1 1 1 1 1
1 1 1 1 1
1 b e 1 1
1 1 1 x 1
1 1 1 1 1