0 1 1 1 e
x 1 1 1 1
1 1 1 1 1
1 1 x 1 1
1 1 x 1 x
1 1 1 1 x