1 1 1 1 x b
1 1 1 1 1 1
1 x x 1 1 1
1 1 1 1 1 1
x x 1 1 1 e