1 1 e 1 1
1 1 1 1 1
1 1 1 1 1
1 1 1 1 1
1 1 b 1 1